#######################
#0 ^###<   <         E#
#   ### ####### #######
#   ###<   <     #    #
#<    #^#######    <# #
####  # #   #    ## # #
#     # # # # ##    # #
#    <# # # #  # #### #
#   < # # # #  #  <   #
#  <  #   # # ## <    #
# <   # # # #^ #<     #
# ### # # # ## # #### #
#<      #< ^          #
#######################
