############################################################################################################
#                                                                                                          #
#22221111 1 11####         0                                                                               #
#                                                                                                          #
#                                                                                                          #
#                                                                                                          #
#                                                                                                          #
#                                                                                                          #
#                                                                                                          #
#                                                                                                          #
#                                                                                                          #
#                                                                                                          #
#                                                                                                          #
#                                                                                                          #
#                                                                                                          #
#                                                                                                          #
#                                                                                                          #
#                                                                                                          #
#                                                                                                          #
#                                                                                                          #
#                                                                                                          #
#                                                                                                          #
############################################################################################################
