#####################
#O                  #
### ############### #
#   #      D      # #
# # # ########### # #
# # #           # # #
# # ########### # # #
# #           # # # #
# ########### # # # #
#           # # # # #
########### #   # # #
#           # #   # #
# ########### # # # #
# #           # # # #
# # ########### # # #
# #           # # # #
# ########### # # # #
# #           # #   #
# # ###############D#
#D#                E#
#####################
