##################################################################################################################################################################################################################
#                                                                                           ###                 ###                                                                                              #
#                                                                                        ###                       ###                                                                                           #
#                                                                                      ###   0    ###########         #                                                                                          #
#                                                                                        ##    ###           ##        ##                                                                                        #
#                                                                                          ####                 ##       #                                                                                       #
#                                                                                                                 #       #                                                                                      #
#                                                                                                                  #       #                                                                                     #
#                                                                                                                          #                                                                                     #
#                                                                                 ##################################        #                                                                                    #
#                                                                                 #                                         #                                                                                    #
#                                                                                 #                                         #                                                                                    #
#                                                                                 #                                         #                                                                                    #
#                                                                          ##               # ############################ ##      #                                                                             #
#                                                                         # #      #                                              # #                                                                            #
#                                                                         # #      #       ##                  222                # #                                                                            #
#                                                                        #   #      #        #                                   #   #                                                                           #
#                                                                        #    #      ##       ##               ###              #    #                                                                           #
#                                                                       #              #        #####     ####    ##           #     #                                                                           #
#                                                                       #      ##       ##            ###          ###        #      #                                                                           #
#                                                                       #        #        ###                     ##         #       #                                                                           #
#                                                                                 ##         ####             ####         ##        #                                                                           #
#                                                                        #          #            ####    #####            #          #                                                                           #
#                                                                        #           ###                #              ##            #                                                                           #
#                                                                         #             ###             #           ###             #                                                                            #
#                                                                         #                ####         #       ####                #                                                                            #
#                                                                          #                   ######    #######                   #                                                                             #
#                                                                           #                                                     #                                                                              #
#                                                                            #                                                   #                                                                               #
#                                                                                                                                                                                                                #
#                                                                          ##                                                     ##                                                                             #
#                                                                      ####  ### #                       2222222             # ###   ##                                                                          #
#                                                             ###    ##   ###      ##                                     ##      ###  ###    ##                                                                 #
#                                                          ###    ###  ##            ###                               ###           ###  ###    ###                                                             #
#                                                         #                             ###                         ###                 #           #                                                            #
#                                                        #            #                    ######             ######                    #            #                                                           #
#                                                        #            #                           ###    ####                           #            #                                                           #
#                                                        #                                              #                               #            #                                                           #
#                                                                                                       #                                                                                                        #
#                                                       #   #########  #                                #                              #  #########                                                              #
#                                                      #   #         # ###                              #                            ## ##         #   #                                                         #
#                           ############              #   #            #  ##                            #                          ## ##            #   #              ############                              #
#                    ######             ######       #  ##               #  ##                          #                        ##  #               #   #       ######             ######                       #
#                       #####                  ###  #                     ##  #                         #                      ##  #                  #   #  ###                 ######                          #
#                             ###                 #                         ##  #                       #                     #  ##                        ##                 ###                                #
#                                ##                                           ## ##                     #                   # ###                                           ##                                   #
#               ####               ##                  #                        #  ##                   #                 ## ##                        #                 ##                 ##                   #
#        #####        #####          ##                  #                        #  ##                 #               ##  #                        #                  #           #####       ######           #
#    ###                    ###        #                  #                        ##  ##               #             ##  #                        ##                  #        ###                    ##        #
#  ##                          #        ##                 ##                        ##  #              #            #  #                                            #        ##                          #      #
# #         ############         #        #                                            ##  #      ###    ####      #  ##                         #                  #       ##         ############         #    #
##       ###            ###       ##      #                  #                           ##  # ##            ### # ###                                             #       #        ###            ###       ##  #
#  ##   #                  #        #                         #                            #                       #                            #                  #      #       ##                  #          #
#    ##                     ##       #      #                                              #                       #                           #                  #      #       #                      #       ##
#                             #      #      #                  #                          #  2222222222222          #                          #                        #       #                        #      ##
#                                     #      #                                           #                           #                                           #      #      #                                 #
#              ###############        #      #                  #                        #             2222222222    #                                                  #      #                          #      #
#                                      ######                    ########################                             ########################                    #####                                   #      #
#                                      ######                    ########################              E              ########################                    #####                                   #      #
#              ###############        #      #                  #                        #                           #                                                                                    #      #
#                                     #      #                 #                         #                           #                                           #      #      #                                 #
#                             #      #      #                  #                          #                         #                          #                 #      #       #                        #      ##
#                            #       #      #                                              #                                                   #                  #      #       #                      #       ##
#   #####                  #        #                         #                            #                                                    #                  #      #       ##                  #          #
####     ###            ###       ##      #                  #                           ##  ####             ####  ##                                                     #        ###            ###       ##  #
###         ############         #                                                     ##  #      ###    ####      #  ##                         #                  #       ##         ############         #    #
#  ##                          #        #                   #                        ##  #              #            #  #                                            #        ##                          #      #
#    ###                    ###        #                  #                        ##  #                #             ##  #                        ##                  #        ###                    ##        #
#        #####         ####          ##                  #                        #  ##                 #               ##  #                        #                  #           #####        #####           #
#               ###                ##                  #                        #  ##                   #                 #  ##                       ##                  #                 ##                   #
#                                ##                                           ##  #                     #                   #  ##                                           ##                                   #
#                             ###                                           ##  #                       #                     #  #                                            ###                                #
#                       #####                  ###  #                     ##  #                         #                      #   #                  #   #  ###                  #####                          #
#                    ######              #####       #                   #  #                           #                        #   #               #   #       #####              ######                       #
#                           ############              #   #            #  ##                            #                          ## ##            #   #              ############                              #
#                                                      #   #         # ###                              #                            ## ##         #   #                                                         #
#                                                       #   #########  #                                #                              #  #########                                                              #
#                                                                                                       #                                                                                                        #
#                                                        #                                              #                               #            #                                                           #
#                                                        #            #                           ###    ####                           #            #                                                           #
#                                                        #            #                    ######             ######                    #            #                                                           #
#                                                         #                             ###                         ###                 #           #                                                            #
#                                                          ###    ##   ##            ##                                ###           ###   ##    ###                                                             #
#                                                             ###    ##   ###      ##                                     ##      ###   ##    ##                                                                 #
#                                                                       ##   ##  #                                           # ###   ##                                                                          #
#                                                                          ##                                                     ##                                                                             #
#                                                                                                                                                                                                                #
#                                                                            #                                                   #                                                                               #
#                                                                           #                                                     #                                                                              #
#                                                                          #                    #####     #####                    #                                                                             #
#                                                                         #                ####         #       ###                                                                                              #
#                                                                                       ###             #           ###             #                                                                            #
#                                                                        #            ##                #              ##            #                                                                           #
#                                                                        #          #            ####     ###             #          #                                                                           #
#                                                                                 ##          ###             ###          ##        #                                                                           #
#                                                                       #        #        ###                     ##         #       #                                                                           #
#                                                                       #       #       ##            ###            #               #                                                                           #
#                                                                                      #         ####     ####         #       #     #                                                                           #
#                                                                        #    #      #        ##               #        #            #                                                                           #
#                                                                        #   #      #        #                   #               #   #                                                                           #
#                                                                                  #       #                              #                                                                                      #
#                                                                         # #      #                                       #      # #                                                                            #
#                                                                          ##                                               #      #                                                                             #
#                                                                                 #                                         #                                                                                    #
#                                                                                 #                                         #                                                                                    #
#                                                                                 #                                         #                                                                                    #
#                                                                                 #################################         #                                                                                    #
#                                                                                                                          #                                                                                     #
#                                                                                                                  #       #                                                                                     #
#                                                                                                                 #       #                                                                                      #
#                                                                                           ###                 #        #                                                                                       #
#                                                                                        ##     ##           ##                                                                                                  #
#                                                                                      ###         #########          #                                                                                          #
#                                                                                        ##                         ##                                                                                           #
#                                                                                           ##                   ##                                                                                              #
##################################################################################################################################################################################################################
