###############
#0 #   #      #
#    #    #   #
# ########   <#
# #<       ####
# #  #    #   #
# # ####### # #
# #     <#   <#
# ###    # # ##
# #<     #<   #
# ###### # ## #
#<  <      #E #
###############
