############################################################################################################################################################
#                                               ###                           ###                            ###                                     ########
##       ###################################    ###  ############################    ####################    ###    ###############################   #######
####     #######                                ###  ##                                                 ##   ###                               #####    #####
######    #####   #########################   #####  ##    ##########################################   ###  ###############################    #####    #####
########     ###   ###########                       ##                         ##                      ###                          #######    ####    #####
  #######      ###    ######   #############################################    ##    ###########################     ############   #######  ####    ######
    #######      ####   #####  #############################################    ###                       ########   ##############  #####   ####    #####
       #######     ####      #   #########    #######                         ###########################  #####   ###############  ####   ####   #######
         ########    #####  ####   #####   ##   ####    ##################################################  ###  ####     ######   ####  ####    ######
           ########     ###   ####  #####  ####   ###   ################################################# ###  ###    ## #####     ##   ###    ######
              ########    ####    #   ####   ####  ####  ######                                    ####  ###  ##    ##  ####          ###    #######
                #########   #####        ###   ###   ###  #####                                 #####  ##   ###   ##   ##      ########    #######
                  #########    #########   ###   ###   ##    #################               ######  ###  ###   ##   ##   ###########   ########
                    #########        ####    ###   ###   ##    ###############     ###############  ##   ##   ##   ###  ####         ########
                       #########        ###    ###   ###   ##       ###########   #########        ##  ##   ###  ##    ##       ######
                         ###########      ##     ###   ###  #######        ####   ###        ######   #   #### ###  ###        ######         
                           ###########     ##       ##   ##    ##########   ###   ###  ##########   ##  ###### #   ###         #####
                             ##########    ##    ##       ####        ####  ###   ###                 ########   ###      #   #####
                                ########     #    ########################  ###   ##################################    ###  #####
                                  #######     ###    ###################    ###   ##########################          ####  #####
                                     ######     ####                        ###                      ###########    ####   ######
                                       ######      #######################################  ########      ############    #####
                                          ######                                        1        ########               ######
                                            ####################################   #######  ####         ########      ######
                                              ##################################    #####   ###########      ##############  
                                                                              ##      ###   ############################                
                                                                              ##       ##    ##########################                 
                                                                              ##     0 ##    ##########                                                                                                                 
                                                            ##############################  ##########                                                                                                                 
                                                            ##############################  #########                                                                                
                                                             #############################  ###########                                                   
                                                              ####2                 #####   ##  2#######                                            
                                                                #####2                 ##   #     2#####                                             
                                                                 #######                         #######                                          
                                                                    ######           2         ######                                             
                                                                     #######                 ######                                               
                                                                        ######              ######                                                
                                                                          ######          #####                                                   
                                                                            ######      ####                                                      
                                                                              ######E #####                                                       
                                                                                 ########                                                         
                                                                                   #####                                                          
                                                                                                                                                  
                                                                                                                                                  
                                                                                                                                                  
                                                                                                                                                  
                                                                                                                                                  
                                                                                                                                                  
                                                                                                                                                  
                                                                                                                                                  
                                                                                                                                                  
                                                                                                                                                  
                                                                                                                                                  
                                                                                                                                                  
                                                                                                                                                  
                                                                                                                                                  

