#####################
#O                  #
### ############### #
#   #             # #
# # # ########### # #
# # #           # # #
# # ########### # # #
# #           # # # #
# ########### # # # #
#           # # # # #
########### # # # # #
#           # #   # #
# ########### # # # #
# #           # # # #
# # ########### # # #
# #           # # # #
# ########### # # # #
# #           # #   #
# # ###############2#
#2#               2E#
#####################
