######################
#0#E                 #
# ########  ######## #
# #M#  #M#  #M#  #M# #
#                    #
# ################## #
#                    #
######################
