########################################
#6  ###       #  #   #        #   #  6##
#        ####      #   # ####   # # #  #
# ###################### #  ### # # ####
#                             # #      #
# ######################### # ######## #
# # #                       #        # #
# # #  ########## ########### ######## #
#   #             #0#                # #
# # #  # ########## # ################ #
# # # ## #          # #         #### # #
# # # # ## ########## # ######         #
# # #   #  #          # # #  #  # #### #
# #   #      ##########   #     # #    #
# ### ################# # #### #### ## #
#6                    # #E  #        #6#
########################################
