################################################################################################################
#0   ###########################################################################################################
# #             ################################################################################################
# # <           ######          ################################################################################
# #  <          ###### ######## ################################################################################
# #   <         ###### ######## ################################################################################
# #    <        ###### ######## #########       ################################################################
# #     <       ###### ######## ######### ##### ################################################################
# #      <      ###### ######## ######### ##### ################################################################
# #             ###### ######## ######### #####                                                                #
# #             ###### ######## ######### #################################################################### #
# #             ###### ######## ######### #################################################################### #
# #^            ###### ######## ######### #################################################################### #
# #################### ########           #################################################################### #
#                      ####################################################################################### #
############################################################################################################## #
############################################################################################################## #
###############################################                                                                #
############################################### ################################################################
############################################### ################################################################
############################################### ################################################################
############################################### ################################################################
############################################### ################################################################
############################################### ############                                                   #
############################################### ############ ################################################# #
############################################### ############ ################################################# #
############################################### ############ ################################################# #
############################################### ############ ################################################# #
############################################### ############ #####                                             #
############################################### ############ ##### #############################################
############################################### ############ ##### #############################################
############################################### ############ ##### #############################################
############################################### ############ ##### #############################################
############################################### ############ ##### #############################################
############################################### ############ ##### #############################################
#                                               ############ ##### #############################################
# ########################################################## ##### #############################################
# ########################################################## ##### #############################################
# ########################################################## ##### #############################################
# ########################################################## ##### #############################################
# ########################################################## ##### #############################################
# ########################################################## ##### #############################################
#                                                            ##### #############################################
################################################################## #############################################
#E                                                                 #############################################
################################################################################################################
