#####################
#O                  #
### ############### #
#   #      D      # #
# # # ########### # #
# # #           # # #
# # ########### # # #
# #           # # # #
# ########### # # # #
#           # # # # #
########### # # # # #
#           # #   # #
# ########### # # # #
# #           # # # #
# # ########### # # #
# #           # # # #
# ########### # # # #
# #           # #   #
# # ###############D#
#R#               WE#
#####################
