#######################
#E#   #   #   #   #B  #
# # # # # # # # # # # #
# # # # # # # # # # # #
# # # # # # # # # # # #
#B#0#   #   #   #    B#
# ################# # #
#                     #
####### #############B#
# #   # #             #
#   # # # ######  # # #
# # #   # #   #     # #
# ####### # # # #   # #
#           #   # #  B#
#######################
